000 041 042 000 018 000 018 018 000 000 041 042 000 018 000 018 130 131 132 018 018 104 041 042 000
000 043 044 071 110 111 112 113 114 071 043 044 045 046 000 133 134 135 136 137 000 105 043 044 018
045 046 088 072 115 116 117 118 119 072 041 042 047 048 000 138 139 140 141 142 000 106 000 041 042
047 048 089 071 120 121 122 123 124 071 043 044 000 000 000 143 144 145 146 147 000 016 076 043 044
041 042 018 072 125 126 127 128 129 072 000 000 000 070 076 000 000 015 000 076 018 000 077 000 000
043 044 000 016 000 076 015 000 076 000 000 000 000 000 077 011 001 008 000 077 000 000 000 018 000
018 049 050 000 000 077 013 012 077 002 001 001 001 001 001 005 000 000 000 016 000 000 016 000 000
000 051 052 000 018 000 000 013 001 005 073 000 016 000 073 015 016 000 000 000 000 070 000 000 018
045 046 000 107 000 000 016 000 000 015 074 016 000 000 074 007 001 012 016 000 000 000 000 016 000
047 048 000 108 000 000 000 000 000 015 075 078 079 080 075 015 000 013 001 001 001 001 001 012 000
076 016 000 109 000 000 092 000 088 015 073 081 082 083 073 015 000 000 016 000 000 000 000 015 000
077 000 016 087 000 000 093 000 089 015 074 084 085 086 074 015 070 016 000 000 000 000 000 000 000
000 016 000 000 016 000 000 000 000 015 075 000 016 000 075 015 000 016 000 107 000 076 000 000 000
096 095 095 095 095 095 095 095 097 013 001 001 003 001 001 014 018 000 018 108 000 077 000 101 000
094 090 090 090 090 090 090 090 094 016 016 000 015 016 104 000 071 000 070 109 000 000 000 102 018
094 090 090 090 090 090 090 090 094 000 000 000 015 000 105 000 072 018 110 111 112 113 114 000 071
094 090 090 090 090 090 090 090 094 000 000 000 015 000 106 076 071 000 115 116 117 118 119 016 072
094 090 090 090 090 090 090 090 094 088 000 000 013 001 012 077 072 000 120 121 122 123 124 000 071
094 090 090 090 090 090 090 090 094 089 041 042 000 076 013 001 012 000 125 126 127 128 129 000 072
098 095 095 095 095 095 095 095 099 000 043 044 000 077 000 000 013 001 001 001 014 000 000 103 000