41 42 00 18 00 49 50 00 41 42 00 34 21 21 21 32 00 18 00 00 49 50 18 00 18
43 44 49 50 18 51 52 00 43 44 00 00 00 00 39 34 21 21 32 18 51 52 00 41 42
41 42 51 52 00 00 00 00 00 16 00 00 16 41 42 00 00 00 34 21 21 21 32 43 44
43 44 00 00 00 00 00 00 00 00 00 00 00 43 44 00 00 16 00 00 00 00 34 32 00
16 18 00 00 00 00 00 00 00 40 00 16 00 00 00 00 00 00 00 40 00 00 39 22 18
18 16 00 00 00 00 18 00 16 00 00 00 00 00 16 00 00 18 00 00 00 16 00 22 00
00 16 00 00 00 00 00 00 00 53 54 39 00 00 00 00 16 00 00 00 00 00 00 34 32
00 00 00 00 16 00 00 00 00 55 56 00 00 00 49 50 00 00 00 16 00 00 00 00 22
00 15 00 00 00 00 00 00 11 01 01 01 01 12 51 52 00 40 00 00 16 00 00 00 22
00 15 00 18 00 02 01 01 14 40 16 41 42 13 01 12 00 00 00 00 00 00 16 00 22
00 13 01 12 00 15 40 00 16 00 00 43 44 16 00 15 00 00 00 16 00 00 00 00 22
18 00 00 13 01 09 12 00 00 00 00 00 18 00 00 15 00 00 00 00 00 16 49 50 22
25 00 00 00 00 00 13 12 00 18 39 02 01 01 01 14 00 16 41 42 00 00 51 52 22
26 41 42 00 00 00 00 13 01 01 03 14 00 00 00 00 00 39 43 44 00 16 00 00 22
26 43 44 00 00 00 00 00 00 00 15 00 00 00 16 53 54 16 00 00 00 00 00 31 33
35 25 49 50 00 00 00 00 00 00 13 12 00 16 00 55 56 00 00 00 00 00 00 22 18
35 26 51 52 00 00 00 00 00 00 00 15 00 00 00 00 00 00 00 41 42 00 16 22 00
35 35 24 25 18 00 16 00 00 00 00 15 16 00 00 16 00 00 00 43 44 31 21 33 18
35 35 35 35 25 16 16 18 41 42 00 15 00 40 00 00 00 00 31 21 21 33 41 42 18
35 35 35 35 35 24 24 25 43 44 00 15 00 00 00 31 21 21 33 18 00 00 43 44 00